000000111111100
111100111001100
111111111001111
1S1100000001141
111100000001111
000000000000111