1110000000
1S11110000
1111111110
0111111111
0000011411
0000001110